slavar --- обращаться небрежно
kanske --- может быть
hoppar --- прыгать
i stallet --- вместо
ordentlig --- хороший, аккуратный
ute --- за пределами дома
andra --- другие
rejäl --- крупный, надёжный
heller --- тоже(не)(в отриц.предлож.)
ungefär --- примерно
tallrik --- тарелка
gröt --- каша
brer --- намазывать
avslutar --- закончить
så --- так
då --- тогда
får --- получать
bråttom --- спешить
svettas --- потеть
ledsen --- грустный
feber --- лихорадка
lagom --- достаточно
består av --- состоит из
varmrätt --- второе блюдо
fläsk --- свинина
en skiva bröd --- кусок хлеба
gärna --- нередко, с удовольствием
slutligen --- наконец
däremot --- зато
lätt --- легкий
måltid --- еда
råd --- совет
inne --- внутри
snäll --- добрый
skyndar --- торопиться
bland --- среди
godiset --- сладости
